12:12
0
17 17 17 17 17 17 0  0  0  0  0  0
17 0  0  0  17 17 0  17 17 17 17 17
17 0  17 0  17 0  96 0  0  0  0  17
17 0  17 0  17 17 17 17 17 17 0  17
17 0  17 0  0  0  0  96 54 17 0  17
17 0  17 0  0  0  17 17 17 17 0  17
17 0  17 17 17 17 17 0  0  0  0  17
17 96 0  0  0  17 17 0  17 17 17 17
17 17 17 17 0  17 0  0  17 0  0  0
0  0  0  17 0  17 17 0  17 0  0  0
0  0  0  17 0  0  0  0  17 0  0  0
0  0  0  17 17 17 17 17 17 0  0  0
