12:12
1
38 0  0  0  0 96 64 0  0  0  0  0
17 17 17 0 17 0  17 17 17 17 0  0
0  96 0  0  17 38 17 0  0  17 0  0
38 0  0  0  17 32 17 0  0  17 0  0
0  0  0  0  17 32 17 0  0  17 0  0
0  0  0  0  17 17 17 0  96 17 0  0
0  0  0  0  0  0  0  0  0  17 0  0
0  18 37 18 0  0  0  0  0  17 0  0
0  18 18 18 0  0  0  0  0  17 0  0
0  0  0  0  0  0  0  0  0  17 0  0
0  17 17 17 17 17 17 17 17 17 38 0
0  0  51 0  0  0  0  0  0  0  0  0
