12:12
0
17 0  0  0  0  0  0  0  96 0  0  64
17 17 17 0  17 0  17 17 17 17 0  0
0  0  0  0  17 32 17 0  0  17 0  0
37 0  0  0  17 32 17 0  0  17 0  0
0  0  0  0  17 37 17 0  0  17 0  0
0  0  0  0  17 17 17 0  0  17 0  0
0  0  0  0  0  0  0  0  0  17 0  96
96 18 17 18 0  0  0  20 0  17 0  0
0  18 18 18 0  0  0  0  0  17 0  0
0  0  0  0  0  0  0  0  0  17 0  0
38 17 17 17 17 17 17 17 17 17 32 32
37 0  0  51 0  0  0  0  0  0  0  0
