12:12
0
56 0  0  0  18 0  18 0  0  0  0  0
0  0  0  0  17 0  17 0  0  0  0  0
0  0  0  0  18 0  18 0  0  0  0  0
0  0  0  38 36 0  17 0  0  0  0  0
17 18 17 37 34 0  18 17 18 17 18 17
0  0  0  0  0  0  0  0  0  0  0  0
17 18 17 18 17 0  32 32 17 18 17 18
0  0  0  0  18 0  32 0  0  0  0  0
0  0  0  0  17 0  17 0  0  0  0  0
0  0  0  0  18 0  18 0  0  0  0  0
0  0  0  0  17 0  17 0  0  0  0  0
0  0  0  0  18 0  18 0  0  0  0  0
