12:12
0
0  0  0  0  34 0  17 0  32 0  38 52
0  0  0  0  0  0  0  38 0  0  38 18
17 0  17 0  17 0  32 0  18 0  32 0
0  32 0  17 0  0  0  17 0  32 0  17
32 0  38 0  34 0  0  0  32 0  17 0
0  17 0  32 0  0  34 0  0  17 0  32
18 17 18 17 18 0  17 18 17 18 17 18
0  32 0  18 0  36 0  17 0  0  0  17
32 0  32 0  32 0  0  0  38 0  18 0
0  17 0  38 0  17 0  32 0  17 0  18
17 0  17 0  17 0  32 0  0  0  32 0
0  36 48  0  0  38 0  17 0  36 0  0
